R 1980 1080
NO ./textures/bluestone.xpm
SO ./textures/greystone.xpm
WE ./textures/wood.xpm

EA ./textures/redbrick.xpm
S ./textures/barrel.xpm
F 28,140,60


C 51, 31, 11


111111111111111111
120000011100000021
100000000000000001
100000000000000011
10000000W000000001
100000000000000011
100000000000000001
120000001000000021
111111111111111111