R 800 600

NO ./textures/bluestone.xpm
SO ./textures/greystone.xpm
WE ./textures/wood.xpm

EA ./textures/redbrick.xpm
S ./textures/barrel.xpm

F ./textures/colorstone.xpm
C ./textures/nightsky.xpm


        1111111111111111111111111
        1000000000110000000000001
        1011002001110000000000001
        1001000000000000002000001
111111111011000001110000000000001
1000000000110000011101111101111111111111
11110111111111011100000010001   101
11110111111111011101010010201   111
11000000110101011100000010201
10000002220000001100000010201
10000000000000001101010010001
11000001110101011111011110N0111
11110111 1110101 101111010001 
11111111 1111111 111111111111
1111111
11111111